........+...........
........|...........
........|...........
........|...........
........|...........
........|...........
........|.........#.
.#......|.........#.
.#......|.........#.
.#......|.........#.
.#.....|||||||||||#.
.#||||||~~~~~~~~~~#.
.#~~~~~~#~#~~~~~~~#.
.#~~~~~~#~#~~~~~~~#.
.#~~~~~~#~#~~~~~~~#.
.#~~~~~~###~~~~~~~#.
.#~~~~~~~~~~~~~~~~#.
.#~~~~~~~~~~~~~~~~#.
.#~~~~~~~~~~~~~~~~#.
.#~~~~~~~~~~~~~~~~#.
.##################.